1111111111111111111111111111111111
1E00000X0000000C00000C000000000001
1010010100100000101001000000010101
1010010010101010001001000X00010101
100000000C00C0000000000000000000C1
100000X000000000000000000000000001
100000000000000C00000C000000000001
1010010100100000101001000000010101
1010010100100000101001000000010101
1010010100100000101001000000010101
1010010100100000101001000000010101
10100101001000001010010000X0010101
1010010100100000101001000000010101
1010010100100000101001000000010101
10100101001000X0101001000000010101
1010010100100000101001000000010101
10100101001000P0101001000000010101
1C10X1010010000X101001000000010101
1111111111111111111111111111111111
