11111111
100100C1
10001001
1P0E0C01
11111111
