11111111111111111111111111111111111111111111111111111111111111111111
1E0000000000000C00000C0000000000001010010100100000101001000000010101
10100101001000001010010000000000000000000000000000000000000000000001
10100100101010100010010000000101001010010100100000101001000000010101
100000000C00C0000000000000000000C01010010100100000101001000000010101
10000000000000000000000000000000001000010100100000101001000000010101
100000000000000C00000C0000000000001000010100100000101001000000010101
10100101001000001010010000000101001010010100100000101001000000010101
101001010010000010100100000001010000100101001000C0101001000C00010101
10100101001000001010010000000101001010010100100000101001000000010101
10100101001000001010010000000101001010010100100000101001000000010101
10100101001000001010010000000101000010010100100000101001000000010101
101001010010000010100100000001010010000101001000001010010000P0010101
10100101001000001010010000000101001000010100100000101001000000010101
10100101001000001010010000000101001010010100100000101001000000010101
10100101001000001010010000000101001010010100100000101001000C00010101
10100101001000001010010000000101001010C1010010C000101001000000010101
1C100101001000001010010000000101001010010100100000101001000000010101
11111111111111111111111111111111111111111111111111111111111111111111
