1111111111111
10010000X00C1
10X0011111001
1P0011E0C0001
1111111111111
