1111111111111
10010000000C1
1000011111011
10001100C0001
1110011111111
10010000000C1
100001111101
1P0011E0C0001
1111111111111
